!бав/	— бáвитися
бавл'/	— бáвлюся
бавл/	— бáвлений

!багат/	— багáто
багач	— багáч	
багаць/	— багáцький

!бадил/	— бадили́на
бадил'л'/ — бади́лля

!базік/	— базíкати
базіц'/	— базíці

!балак/	— балáкати		
балач/	— балáчки
	
!баламут — баламýт	  	
баламуч/ — баламýчу
	
!балк/	— бáлка
балц'/	— бáлці	
балок	— бáлок
балоч/	— бáлочка
	
!бар/	— бари́тися	  	
бар'/	— барю́ся

!баран	— барáн	
баран'/	— барáнячий	

!барв/	— бáрва	
/барвл/	— забáрвлений
/барвл'/ — забáрвлювати	

!барліг	— барлíг
барлоз/	— барлóзі
барлож/	— барлóжитися	

!батіг	— батíг	

!батог/	— батогá
батож/	— батóжити
батіж/	— батіжóк

!бат'/	— бáтько
бат/	— бáтенько

!бджол/	— бджолá
бджіл/	— бджíлка
бджіль/	— бджільни́цтво	

!безпек/ — безпéка
безпец'/ — безпéці
безпеч/	— безпéчний

!берег/	— бéрег	
береж/	— бережи́стий
берез/	— бéрезі
/береж'ж'/ — безберéжжя	
беріж/	— беріжкóм

!берег/	— берегти́
береж/	— бережéний
/беріг/	— оберігáти

!берез/	— берéза
беріз/	— берíзка

!би/	— би́ти	
б/	— бʼю	
бій	— бíйка	
бой/	— бóєм	

!бик	— бик	
биц'/	— бицí	
бич/	— бичáчий

!біб	— біб	
боб/	— бóбом	

!біг/	— бíгти	
біж/	— біжý	

!бій/	— бійці	

!бік	— бік	
боц'/	— на бóці
бок/	— бóком
/боч/	— збóчувати
біч/	— бічни́й
/біч'ч'/ — узбíччя

!біл/	— бі́лий
/біль/	— вибíльник
	
!біль	— біль
/бол/	— збóлений

!блакит/ — блаки́тний
блакить	— блаки́ть
блакит'т'/ — блаки́ттю
	
!близ/	— близéнько
/ближ/	— збли́жений
близь/	— бли́зько
	
!блиск/	— бли́скати	
блис/	— бли́снути
блист/	— блистíти
блищ/	— блищáти
	
!блох/	— блохá	
бліх	— бліх
бліш/	— блíшка
блос/	— блосí
	
!блях/	— бля́ха
бляс'/	— у бля́сі
бляш/	— бля́шка

!Бог	— Бог	
бож/	— бóжий	
Боз/	— (у) Бóзі	

!бой/	— боя́тися	
бій/	— бíйся

!болот/	— болóто
/болоч/	— заболóчений

!бор/	— бóром
бір	— бíр

!борг	— бóрг
борж/	— боржни́к
	
!боро/	— борóтися
борі/	— борíтеся
бор'/	— борю́ся
/бор/	— збóрений

!бород/	— бородá
борід/	— борíдка
/борід'д'/ — підборíддя
	
!борозн/ — борознá
борозень/ — борозéнька	

!борошн/ — борошнó
борошен/ — борошéнце

!бр/	— брáти	
бер/	— берý	
/бир/	— вибирáти
/бор/	— ви́бори
/бір	— ви́бір	

!брат	— брат	
брат'т'/	— брáття

!брех/	— брехáти
бреш/	— брешý
/бріх/	— відбрíхувати	

!бризк/	— бри́зкати
бриз/	— бри́знути

!бров/	— бровá	
брів/	— брíвка

!брод/	— броди́ти
бродж/	— броджý
брес/	— брести́
бред/	— бредý	
бре/	— брелá	
брі/	— брів	
брід	— брід	

!бряз/	— бря́зкати
бряж/	— бряжчáти

!бу/	— бýти	
буд/	— бýду	
будь/	— бýдьте	

!буд/	— буди́ти	
будж/	— буджý	

!будень	— бýдень
будн'/	— бýдній
буден/	— будéнний

!бук/	— бýковий	
буч/	— бучи́на

!букв/	— бýква	

!булк/	— бýлка	
булц'/	— на бýлці
булоч/	— бýлочний	

!буряк	— буря́к	
буряч/	— бурячи́ння

!ваг/	— вагá
ваз'/	— вазí
важ/	— вáжити

!вад/	— вáдити
вадж/	— вáджу	

!вал/	— вали́ти	
/валь/	— навáльний

!ватаг/	— ватáга
ватаз'/	— ватáзі
ватаж/	— ватажóк
	
!ведмед/ — ведмéдик
ведмідь	— ведмíдь
ведмеж/	— ведмежá
	
!верг/	— вéргати
верж/	— вéржений

!вереск	— вéреск
верес/	— вереснýти
верещ/	— верещáти
	
!веретен/ — веретéно
веретін/ — веретíнце

!верт/	— вертáти
вер/	— вернýти
ворот'т'/ — вороття́

!верт/	— вертíти
верч/	— верчý
	
!верх	— верх
верш/	— верши́ти

!весел/	— весéлий
весель/	— весельчáк

!весіль/ — весíльний
весіл'л'/	— весíлля
	
!весл/	— веслó	
весел	— вéсел	
весель/	— весéльце

!весн/	— веснá	
весін/	— весíнній

!вечір	— вéчір
вечор/	— вéчора	
вечер'/	— вечéряти

!ви/ — ви́ти (крутити)
в/ — вʼю
	
!ви/	— ви́ти (видавати протяжні звуки)

!вигод/	— ви́года
вигід/	— ви́гідний
вигід'д'/ — вигíддя

!вид/	— видáти
видж/	— ви́джу	
вид'д'/	— приви́ддя
/виж/	— ввижáтися

!/вик/	— звикáти
/вич/	— зви́чка

!вил/	— ви́ла	
виль/	— вильнýти

!вираз/	— вирази́стий
вираж/	— виражáти

!вис/	— висíти
виш/	— вишý	
віш/	— вíшати

!вис/	— висóкий
вись	— вись	
вис'с'/	— ви́ссю	
виш/	— вишинá

!виск	— виск	
вищ/	— вищáти

!висок/	— висóк	
виск	— вискóм

!вихор	— ви́хор	
вихр/	— вихрáстий

!вишн'/	— ви́шня	
вишн/	— вишнéвий
вишень/	— ви́шенька

!/ві/	— повівáти	
вій/	— війнýти

!вівторок — вівтóрок	
вівторк/ — вівтóрка	

!вівц'/	— вівця́	
вівч/	— вівчáр
овеч/	— овéчий
овець	— овéць	

!відлиг/ — відли́га
відлиз'/ — відли́зі

!відр/	— відрó	
відер/	— відéрце

!вій/	— війнá	
вой/	— войовни́чий
	
!вік	— вік
віц'/	— у вíці
віч/	— вíчний

!вікн/	— вікнó
вікон/	— вікóнний
/вікон'н'/	— підвікóння
	
!віл	— віл
вол'/	— воля́чий

!вільх/	— вíльха
вільс'/	— у вíльсі
вільш/	— вільши́на
	
!віник	— вíник
вінич/	— вíничок

!вісім	— вíсім
восьм/	— вóсьмий
	
!віст/	— вíстка
вість	— вість
віс/	— вíсник
віщ/	— вíщий

!віт/	— вíтка	
віт'т'/	— вíття

!вітер	— вíтер	
вітр/	— вíтром

!влад/	— влáда
/влад'д'/	— двовлáддя

!власт/	— власти́тель	
/власн/	— привлáснювати
влас/	— влáсний

!внук	— внук
онук/	— онýка
онуч/	— онучá
онуц'/	— онýці
внуц'/	— внýці	
внуч/	— внучá	
онучч/	— онýччин
внучч/	— внýччин
	
!вовк	— вовк	
вовч/	— вóвчик
вовц'/	— вовцю́га
	
!вогонь	— вогóнь
вогн/	— вогнéнний
огн/	— огнéнний

!вод/	— водá	
/водь	— тиховóдь
/від'д'/ — безвíддя	
/вод'д'/ — безвóддя

!вод/	— води́ти
водж/	— воджý	
вож/	— вожáк	
/вад/	— провáдити
/вадж/	— провáджу
вес/	— вести́	
вед/	— ведý	
ві/	— вів	
ве/	— вели́	
/від/	— звíдний

!воз/	— вози́ти
вож/	— вожý	
вез/	— везти́	
/віз/	— завізни́й

!волог/	— волóгий
волоз'/	— волóзі 
волож/	— волóжити

!волок/	— волокти́	
волоч/	— волочý
волоц'/	— волоцю́га
волік	— волíк	

!волокн/ — волокнó
волокон/ — волокóнце

!волос	— вóлос	
волос'с'/ — волóсся

!волот/	— волотéвий
волоть	— вóлоть
волот'т'/ — волóття

!воль/	— вóльний
вол/	— вóленька	
віль/	— вíльний
/віл'л'/ — привíлля

!ворог	— вóрог	
ворож/	— ворóжий
ворíж/	— воріжéньки

!ворон/	— ворóна
ворон'н'/ — ворóння

!ворот/	— ворóта
воріт	— ворíт	

!воск/	— воскóваний
віск	— віск
вощ/	— вощи́на
	
!вугіль/ — вугíльний
вугіл'л'/ — вугíлля
вугл/	— вугли́на

!вуд/	— вýдити
вудж/	— вýджу
	
!вуз/	— вузéнький
вузь/	— вузьки́й
/вуж/	— звýжувати

!вузол	— вýзол
вузл/	— вýзлик
	
!вух/	— вýхо	
вус/	— у вýсі
вуш/	— вýшко

!/в’яд/	— зав’ядáти	
в’я/	— в’я́нути
	
!в’яз/	— в’язáти
/в’язь	— пóв’язь
в’яж/	— в’яжý

!гад/	— гадáти	
/гадь/	— угáдько

!гад	— гад	
гад'д'/	— гáддя

!гак — гак
гац'/	— на гáці	
гач/	— гачóк
	
!галуз/	— галýзка	
галузь	— гáлузь	
/галуж/	— розгалýжитися	
галуз'з'/ — галýззя

!галушк/ — галýшка
галушц'/ — галýшці
галушок	— галушóк

!гамір	— гáмір
гамор/	— гáмору
	
!гас/	— гаси́ти	
гас'/	— гáсять	
гаш/	— гашý
	
!гат/	— гати́ти
гач/	— гачý
гать	— гать	
гат'т'/	— гáттю	

!гвинт/	— гвинти́ти
гвинт'/	— гвинтя́ть
гвинч/	— гвинчý

!гвізд/	— гвіздóк
гвозд/	— гвозди́ти	
гвождж/	— гвожджý

!гиб/	— ги́бнути
ги/	— ги́нути

!/гин/	— згинáти	
/г/	— зігнýти

!гіл/	— гíлка	
гіл'л'/	— гілля́	

!глад/	— глáдити
гладь	— гладь
гладж/	— глáджу

!глек	— глек	
глец'/	— на глéці
глеч/	— глéчик

!глиб/	— глибóкий
/глибл'/ — погли́блювати	
/глибл/	— загли́блений

!глум/	— глуми́тися
глумл'/	— глумля́ться

!глух/	— глухи́й
/глуш/	— заглушáти	

!/гляд/	— виглядáти
глед/	— гледíти
гледж/	— гледжý

!гн/	— гнáний
ган'/	— ганя́ти
/гон/	— загóнити
жен/	— женý	
/гін/	— загíн	

!гни/	— гнили́й
гній	— гній	
/гной/	— загнóєний

!гнів/	— гнíватися
гнівл'/	— гнівлю́

!гнізд/	— гніздó
/гніждж/ — угнíжджуватися

!гніт/	— гніти́ти
гніт'/	— гнітя́ть
гніч/	— гнічý
	
!гноб/	— гноби́ти	
гнобл'/	— гноблю́
гнобл/	— гнóблений
	
!говор/	— говори́ти
говір	— гóвір
	
!год/	— годи́ти
год'/	— гóдять
/годж/	— догоджáти
/гід/	— догíдливий
/гід'д'/ — догíддя

!голк/	— гóлка
голц'/	— гóлці
голоч/	— гóлочка
голок	— гóлок
	
!голов/	— головá
голів/	— голíвка
/голів'/— безголíв’я
	
!голод/	— голóдний
/голодж/— ви́голоджений

!голос/	— голоси́ти
голос'/	— голóсять
/голош/	— виголóшувати
/голос'с'/ — повноголóсся
	
!голуб/	— голýбити
голубл'/	— голýбляться	
голубл/	— голýблений
	
!гомон/	— гомони́ть	
гомон'/	— гомоня́ть	
гомін	— гóмін
	
!гор/	— гори́ть	
гор'/	— горя́ть
/гар/	— недогáрок

!гор/	— горá	
гір/	— гірськи́й

!горб/	— гóрбитися	
горбл'/	— гóрблюся	
/горбл/	— згóрблений
	
!горіх	— горíх
горіс/	— на горíсі
горіш/	— горíшок
	
!город/	— городи́ти
/городж/ — загорóджений	

!горох	— горóх	
горос'/	— у горóсі
горош/	— горошóк

!горт/	— гортáти
гор/	— горнýти	

!горшк/	— горшки́
горщ/	— гóрщик

!гост/	— гости́ти
гість	— гість	
/гощ/	— пригощáти	

!готов/	— готóвий
готу/	— готувáти
готовл'/ — готóвлю	
/готівель/ — заготівéльний
готів/	— готíвка

!гр/	— грáти	
ігр/	— íгри	

!граф/	— графи́ти	
графл'/	— графлю́

!греб/	— гребти́
/гріб/	— загрібáти

!гривн'/ — гри́вня
гривень	— гри́вень
гривен/	— гри́веник

!гріх/	— гріхóвний
гріш/	— грíшний

!гріз/	— грíзний
/грож/	— загрóжувати	
грізь/	— грізьбá
гроз/	— грозá	
/гроз'з'/ — передгрóззя	

!гром/	— грóмом
грім	— грім	
грим/	— гримíти
гримл'/	— гримлю́

!громад/ — громáдити	
громад'/ — громáдять
/громадж/ — нагромáджувати

!грош/	— грóші	
гріш	— гріш	

!груд/	— грýдка
груд'д'/ — грýддя

!груд/	— грýди
/груд'д'/	— погрýддя
	
!груз/	— грýзнути	
грузь/	— грузьки́й
	
!губ/	— губá
/губл'/	— пригýблювати
	
!губ/	— губи́ти	
губл'/	— гýблять	
/губл/	— загýблений

!гус/	— гýси
гусь/	— гусьми́
	
!густ/	— густи́й
гус/	— гýснути
гущ/	— гýща

!ґніт	— ґніт (до лампи)
ґнот/	— ґнóта

!да/	— дáти
дас/	— даси́
дад/	— дадýть
	
!дав/	— дави́ти
давл'/	— давлю́	
давл/	— дáвлений
	
!дал/	— далéкий	
даль	— даль	
дал'л'/	— дáллю
	
!дах	— дах	
дас'/	— на дáсі	
даш/	— дашóк
/даш'ш'/ — піддáшшя
	
!двер/	— двéрі
/двір/	— одвíрок

!двор/	— дворá	
двір	— двір

!дев’ять — дéв’ять	
дев’яту	— дев’я́тий
	
!день	— день
ден/	— дéнний	
дн/	— дни́на
	
!дер/	— дéрти
/дир/	— видирáти
др/	— дрáти
дір'/	— діря́вий
	
!дерн/	— дерни́на
дерен	— дерéн	

!десят/	— деся́тий
десять	— дéсять

!дешев/	— дешéвий
/дешевл/ — здешéвлений

!джерел/ — джерелó
джерель/ — джерéльний

!дзвон/	— дзвони́ти
дзвон'/	— дзвóнять
дзвін	— дзвін	

!див/	— диви́тися
/дивл'/	— видивля́тися	

!дик/	— ди́кий	
дич/	— дичинá

!дим	— дим	
/димл/	— зади́млений	
димл'/	— димля́ться

!дит/	— дити́на
дит'/	— дитя́	

!дишель	— ди́шель
дишл/	— ди́шло	
дишл'/	— ди́шля	

!діл/	— дíло	
/діл'л'/	— бездíлля

!діл/	— діли́ти
/діль/	— подíльний	

!дн/	— дно	
ден/	— дéнцé	
/дон/	— бездóнний
/дн/	— безóдня

!доб/	— добá	
діб/	— діб	

!довб/	— довбáти
/довбл'/ — видóвблювати	
/довбл'/ — ви́довблений	

!довг/	— дóвгий
довж/	— довжинá
довш/	— дóвшати
/довз'/	— невдóвзі

!дой/	— дої́ти	
дій/	— дíйна	

!дол/	— доли́на
діл	— діл
/дол'л'/ — роздóлля
/діл'л'/ — подíлля
	
!дол/	— дóленька
дол'/	— дóля
	
!долон'/ — долóня
долон/	— долóнею
	
!дом/	— домáшній	
дім	— дім
	
!дон/	— дóнечка
донь/	— дóнька

!дорог/	— дорóга
дороз/	— на дорóзі
дорож/	— дорóжній	
доріж/	— дорíжка
/доріж'ж'/	— роздорíжжя

!дорог/	— дороги́й	
дорож/	— дорожи́ти
	
!дошк/	— дóшка
дошц'/	— на дóшці
дощ/	— дóщечка

!драз/	— дразни́ти
драж/	— дражни́ти

!дриг/	— дриготáти	
дриж/	— дрижáти	
дрож	— дрож

!дроб/	— дроби́ти
дріб	— дріб
дробл/	— дрóблений
дробл'/	— дрóблять
	
!дров/	— дровá
дров'/	— дровʼяни́й

!дрот/	— дрóтик	
дріт	— дріт
дрот'т'/	— дрóття

!друг	— друг
друж	— дрýжній	
друз'/	— дрýзі
	
!дрюк	— дрюк
дрюч/	— дрючóк
дрючч'/	— дрю́ччя

!ду/	— дýти	
дуй/	— дýю
	
!дуб	— дуб
/дубл'/	— видýблювати	

!дуг/	— дугá	
дуз'/	— на дузí
дуж/	— дýжка	

!дур/	— дури́ти
дур'/	— ду́рять

!дус/	— дуси́ти
душ/	— видýшую	

!дух	— дух	
дус/	— на ду́сі

!душ/	— душá	
/душ'ш'/ — бездýшшя

!дьоготь — дьóготь
дьогт/	— дьóгтевий
дігт/	— дігтя́р

!/дяг/	— одягти́
/деж/	— одéжа	

!дядь/	— дя́дько
дяд/	— дя́дина

!дяк/	— дя́кувати
/дяч/	— віддя́чити

!єдин/	— єди́ний
єдн/	— єднáти

!єхид/	— єхи́дний

!жа/	— жáти (серпом)	
/жин/	— вижинáти
жн/	— жнець	
жен/	— женцí	

!жа/	— жáти (стискати)
/жим/	— нажимáти
/жм/	— ви́жму	

!жаг/	— жагá	
жаз'/	— жазí	

!жал/	— жáлувати	
жаль	— жаль	

!жал/	— жали́ти

!жар/	— жáрити

!жарт/	— жартувáти

!жах/	— жахáтися

!жвав/	— жвáвий
/жвавл'/	— пожвáвлювати
/жвавл/	— пожвáвлений
	
!жд/	— ждáти

!жер/	— жéрти
	
!/жид/	— дожидáти
	
!/жир/	— вижирáти
	
!жил/	— жи́лавий
жиль/	— жи́льний

!жолоб	— жóлоб	
/жолобл'/	— вижолóблювати
/жолобл/	— ви́жолоблений
	
!жолудь	— жóлудь
жолуд/	— жолудéвий
жолуд'д'/	— жолу́ддя
	
!жон/	— жонáтий
жен/	— жени́тися
жін/	— жíнка
	
!жу/	— жувáти
жов/	— жóваний
жуй/	— жу́йний
	
!жук	— жук
жуц'/	— на жуцí	
жуч/	— жучóк
	
!жур/	— жури́тися
	
!забу/	— забýти
забуд/	— забу́ду
забудь/	— забу́дько

!закон	— закóн
/закон'н'/ — беззакóння
/законн/ — беззакóнний

!загал/	— загалóм
загаль/	— загáльний

!заліз/	— залíзо
заліз'з'/ — залíззя

!заміж	— зáміж
заміж'ж'/ — замíжжя
замуж/	— зáмужем
	
!замок	— зáмок (укріплення)		
замк/	— зáмку
	
!запорож/ — запорóжець
запоріж'ж'/ — Запорíжжя
запорізь/ — запорíзький	
запорозь/ — запорóзький	

!захист	— зáхист
захист'/	— захистя́ть
захищ/	— захищáти
захис/	— захисни́й	


!захід	— зáхід (частина світу)
заход/	— зáходу

!зв/	— звáти	
/зов/	— призовни́й
/зив/	— взивáти

!звук/	— звукови́й
звуч/	— звучáти

!/здоб/	— оздóба
/здобл'/ — оздóблювати	
/здобл/	— оздóблений

!здоров/ — здорови́ти
здоровл'/ — здоровлю́
/здоровл/ — оздорóвлений

!зелен/	— зелéний
зелень	— зéлень
зелен'н'/ — зéленню

!зем/	— земни́й
земл'/	— земля́	
земель/	— земéльний
/земел'л'/ — підземéлля

!зерн/	— зернó	
зерен	— зéрен	

!/зик/	— пóзика
/зиц'/	— пóзиці
/зич/	— пози́чити

!зіл'л'/ — зíлля	
зіль/	— зíльник

!зл/	— злий	
зол	— зол (мн.)

!зозул'/ — зозýля
зозул/	— зозýлин

!золот/	— золоти́й
золоч/	— золочý

!зор/	— зóрі	
зір/	— зíрка		

!зр/	— зри́мий
/зир/	— визирáти
зір	— зір
зор/	— зóром
	
!зрад	— зрáда	
зрад'/	— зрáдять
зрадж/	— зрáджувати

!зразок	— зразóк
зразк/	— зразкóвий
	
!зуб/	— зýбом
/зубл'/	— визýблювати	
/зубл/	— зазýблений
	
!зять	— зять
зят/	— зя́тем
			
!і/	— іти́
ід/	— ідý	
іш/	— ішóв	
й/	— йти	
йд/	— йду
йш/	— йшов
	
!ідеал	— ідеáл
ідеаль/	— ідеáльний
	
!ім/	— íмені
йм/	— ймéнний

!ін/	— íнший
	
!іскр/	— íскра
	
!існ/	— існувáти

!істин/	— íстина
	
!їж/	— їжáк
	
!їзд/	— ї́здити	
їждж/	— ї́жджу
/їз/	— виїзни́й
	
!їс/	— ї́сти
ї/	— їм
їд'/	— їдя́ть
/їд/	— наї́дки
їж/	— ї́жа
їх/	— ї́хати
їд/	— ї́ду
/їждж/	— виїжджáти
	
!кабал/	— кабалá
кабаль/	— кабáльний  

!каблук	— каблýк
каблуц'/ — каблуцí 
/каблуч/ — викаблýчуватися

!кад/	— кади́ти
кадж/	— каджý	

!каз/	— казáти
каж/	— кажý	 

!каламут/ — каламýтити	
каламуч/ — каламýчу 
каламуть — каламýть 
каламут'т'/ — каламýттю

!калік/	— калíка
каліц'/	— калíці
каліч/	— калíчити 

!кап/	— кáпати
капл/	— кáпле	 

!капост/ — кáпостити  
капощ/	— кáпощу
капость	— кáпость
капос/	— кáпосний 

!капуст/ — капýста
капуст'/ — капустя́ний	

!карк — карк

!кат/	— катувáти  
кат'/	— катю́га

!каторг/ — кáторга
каторз'/ — на кáторзі 
каторж/	— кáторжник 	 
        
!кашель	— кáшель
кашл'/	— кáшляти
кашл/	— кáшлем

!квас/	— квáсити
квас'/	— квáсять
кваш/	— квáшу	 

!квіт/	— квíтка (пор. цвіт)  
цвіс/	— цвісти́	    
цвіт/	— цвітý 	    

!квок/	— квоктáти    
квоч/	— квóчка	    

!кид/	— ки́дати
ки/	— ки́нути	    
	    
!кип/	— кипíти   
кипл'/	— кипля́ть
   
!кисть	— кисть	
кист/	— ки́стей
	   
!кишк/	— ки́шка
кишц/	— ки́шці	   
кишеч/	— ки́шечка
 
!кіготь	— кíготь
кігт'/	— кíгтя
кігт/	— кíгтем
  
!кіл	— кіл	
кол/	— колá	   
кіл'л'/	— кíлля
	   
!кінець	— кінéць 
конеч/	— конéчний	   
кінц/	— кінцéвий
кінеч/	— кінéчний
конч/	— кончи́на   
кінч/	— кінчáти
	   
!кінь	— кінь
кін/	— кíнний	   
кон'/	— коня́

!клас/	— клáсти
клад/	— кладý
кла/	— клав
	   
!клеп/	— клепáти   
клепл'/	— клéплять

!клик/	— кли́кати
клич	— клич
	   
!клин	— клин	   
/клин'/	— закли́нювати
	   
!кліт/	— клíтка   
кліть	— кліть	   
кліт'т'/ — клíттю
  
!/клон/	— поклони́тися
/клін/	— поклíн
клан/	— клáнятися

!клопот/ — клопотáти
клопіт	— клóпіт
клопоч/	— клопочýся

!клюв	— клюв
кльов/	— кльóваний
клю/	— клю́нути

!кляс/	— клясти́
/клин/	— проклинáти 
клен/	— кленý 
/кльон/	— прокльóну 
/клін	— проклíн

!книг/	— кни́га	  
книз'/	— у кни́зі
книж/	— кни́жка

!кобил/	— коби́ла
кобил/	— коби́лячий

!ковш	— ковш	
ківш	— ківш	

!кож/	— кожýх	 

!коз/	— козá	  
кіз/	— кíзка	

!козак	— козáк	  
козач/	— козáчий
козаць/	— козáцький 

!кол/	— кóло	
кіль/	— кільцé

!колих/	— колихáти  
колис/	— колисáти 
колиш/	— колишý
/коліс/	— заколíсувати

!колись	— коли́сь	
колиш/	— коли́шній  

!колір	— кóлір	  
кольор/	— кольорóвий 

!коло/	— колóти
кол/	— кóлений
/коль/	— розкóльницький 

!колод/	— колóда		    
колод'д'/ — колóддя  

!колос/	— колосóк  
колос'с'/ — колóсся 
/колош/	— виколóшуватися

!колот/	— колоти́ти 
колоч/	— колочý

!колуп/	— колупáти 
/колупл'/ — виколýплювати 

!комор/	— комóра
комір/	— комíрник 

!коп/	— копи́ти
копл'/	— коплю́

!копійк/ — копíйка	  
копійц'/ — копíйці
копійч/	— копíйчина
	  
!копт/	— копти́ти
копч/	— копчý 
копоть	— кóпоть
	  
!кор/	— кори́ти	  
/кір/	— покíрний
	
!корен/	— коренéвий
корінь	— кóрінь
корін/	— корінéць
корін'н'/ — корíння

!корист/ — користáти
користь	— кóри́сть
корис/	— кори́сний
	  
!короб/	— корóбити
коробл'/ — корóблять
/коробл/ — покорóблений
	  
!коров/	— корóва
коров/	— корóв’ячий
корів/	— корíвка
	  
!корот/	— корóткий
/короч/	— скорóчений
  
!кос/	— косá (предмет)
кош/	— кошý
/кіс	— покíс
кіс'с'/	— кісся́
	   
!кос/	— косá (волосся)	  
кіс/	— кíска

!кос/	— коси́тися (дивитися скоса)
кош/	— кошýся

!кост/	— костенíти
кість	— кість	
кіст/	— кíстка

!кот/	— коти́ти	  
коч/	— кочý
кат/	— катáти
кач/	— качáти
	  
!котел	— котéл
котель/	— котéльний	  
котл/	— котловáн

!кош/	— кóшик	 

!край/	— крáяти
крой/	— крої́ти

!крас/	— крáсити
краш/	— крашý	  

!крас/	— крáсти
крад/	— крадý	 
кра/	— крав	
крадь/	— крадькомá 

!/крем/	— окрéмий
/кремл'/ — відокрéмлювати 

!кри/	— кри́ти	  
/крі/	— покрíвля

!крив/	— криви́й		       
/кривл'/ — викри́влювати 
/кривл/	— ви́кривлений 

!кривд/	— кри́вда
кривд'/	— кри́вдять 
/кривдж/ — скри́вджувати 

!криг/	— кри́га	  
криз/	— кри́зі	
криж/	— крижи́на

!крик/	— кри́кнути 
крич/	— кричáти

!крил/	— крилó	
/крил'л'/ — надкри́лля  
/криль/	— надкри́ль   

!криниц'/ — крини́ця 
криниц/	— крини́цею  
кринич/	— крини́чка

!критик	— кри́тик
критич/	— крити́чний  
критиц'/ — кри́тиці  

!крих/	— крихки́й   
круш/	— круши́ти    

!кріп/	— кріпи́ти		
/кріпл'/ — скрíплювати 
/кріпл/	— закрíплений 

!кров	— кров	  
крив/	— кривáвий  
/крів/	— безкрíв’я 
крів/	— крíвця
кров/	— кров’яни́й 
/кровл/	— знекрóвлений	   
/кровл'/ — знекрóвлювати
	   
!крок/	— крокувáти	   
кроц'/	— крóці
кроч/	— крóчок
	   
!круг	— круг
круж/	— кружля́ти
   
!круп/	— крупá
крупй/	— круп’яни́й
	   
!крут/	— крути́ти
круч/	— крýчу
круть	— круть (хоч круть хоч верть)	

!крюк	— крюк
крюц/	— крюцí	    
крюч/	— крючóк
   
!ку/	— кýзня
куй	— куй (залізо) 
ков/	— кóваний
    
!кубл/	— кýблитися
кубель/	— кубéльце
   
!кулак	— кулáк	    
кулац'/	— у кулацí
кулач/	— кулачи́сько

!куль/	— кýлька
кул/	— кулемéт
   
!куп/	— купи́ти
купл'/	— купля́ти   
купл/	— кýплений
	    
!кус/	— кусáти
/куш/	— викýшувати
  
!кут/	— кутóк
/кут'т'/ — пóкуття
/куть	— пóкуть

!лагод/	— лáгодити
лагодж/	— лáгоджу
   
!лад/	— лáдити
ладж/	— лáджу
/лад'д'/ — безлáддя
	    
!лаз/	— лáзити
лаж/	— лáжу
ліз/	— лíзти	

!ласк/	— ласкáвий 
ласц'/	— лáсці	

!ластів/ — лáстівка 
ластів'/ — ластів’я́та

!лебідь	— лéбідь
лебід/	— лебíдка
лебед'/	— лебедíти 

!леж/	— лежáти
ліг	— ліг
ліж/	— ліжни́к
ляг/	— лягáти
ляж/	— ля́жу	

!леміш	— лемíш	
лемеш/	— лемешéм

!лест/	— лести́ти
лещ/	— лещý	
/лес/	— облéсливий 
/лес/	— облéсний 

!лет/	— летíти
леч/	— лечý	
літ/	— літáти
лет'/	— летя́ть
льот/	— льóтний

!ли/	— ли́ти	
л'л'/	— ллю

!лиз/	— лизáти
лиж/	— ли́жу	

!лип/	— ли́пнути
ліп/	— ліпи́ти
ліпл'/	— лíплять
/ліпл/	— прилíплений 

!лист/	— листóк	
лист'/	— листяни́й 
литк/	— ли́тка	
литок	— литóк	
литц'/	— ли́тці	
литоч/	— ли́точка

!лих/	— ли́хо	
лиш/	— ли́шенько 

!лиц/	— лицé	 
/лиць	— горіли́ць 
лич/	— ли́чко	
/лик/	— безли́кий

!лід	— лід
льод'/	— льодяни́й
льод/	— льóду
 
!лік/	— лікувáти
	
!/лік	— óблік	
ліч/	— лічбá

!лікоть	— лíкоть	
лікт'/	— лíктя	
лікт/	— лíктик	
лікть/	— ліктьови́й
	
!лін/	— ліни́вий
лінь	— лінь
лін'н'/	— лíнню
	
!ліп/	— лíпший	

!ліс	— ліс
/ліс'с'/ — безлíсся

!ліск/	— ліскóвий
ліщ/	— ліщи́на
	
!лов/	— лови́ти
ловл'/	— лóвлю
	
!ложк/	— лóжка
ложок	— лóжок
ложц'/	— на лóжці
ложеч/	— лóжечка
	
!лоз/	— лозá	
лоз/	— лóзяний

!лой/ — лойови́й	
лій — лій
	
!лом/	— ломи́ти	
ломл'/	— ломлю́
/ломл/	— злóмлений
лам/	— ламáти

!лопат/	— лопáта

!лопух	— лопýх
лопус'/	— у лопусí
лопуш/	— лопуши́на	
лопуш'ш'/ — лопýшшя

!лопот'/ — лопотíти
лопоч/	— лопóчуть

!луг	— луг (земля)
луз'/	— на лýзі
луж/	— лýже

!луг	— луг (окис металу)
луз'/	— у лýзі
/луж/	— вилýжнювати 

!лук/	— лукá	
луц'/	— луцí	
луч/	— лучни́й

!лук	— лук (зброя) 
луц'/	— на лýці
луч/	— лýчник

!лукав/	— лукáвий
лукавл'/ — лукáвлю

!лун/	— лунáти
/лун'н'/ — відлýння 

!луп/	— лупи́ти
лупл'/	— лýплять
лупл/	— лýплений 

!луск/	— лýскати
лущ/	— лýщити
лус/	— лýснути

!люб/	— люби́ти
любл'/	— люблю́	
любл/	— лю́блений 

!люд/	— лю́ди	
люд'/	— людьми́
/люд'д'/ — безлю́ддя 

!лют/	— лю́тий	
лють	— лють	
лют'т'/	— лю́ттю	

!ляк/	— лякáти
ляч/	— лячни́й

!ляск/	— ля́скати (про звук)	
лящ/	— лящáти
ляс/	— ляснути

!льон	— льон	
льн/	— льняни́й
ллян/	— лляни́й

!льох	— льох	
льос'/	— у льóсі

!маз/	— мáзати	
маж/	— мáжу	
мазь — мазь
маз'з'/	— мáззю
	
!майбут/ — майбýтній
майбут'т'/	— майбуття́

!мак/	— мáковий
мац'/	— у мáці	
мач/	— мáчок

!мал/	— мали́й	
маль/	— мальóк
	
!/ман/	— обманýти
/ман'/	— обмáнювати
	
!масл/	— мáсло	
масел	— мáсел
масл'/	— мáсляний
	
!маст/	— масти́ти
масть	— масть
мащ/	— мащý	
мас/	— масни́й
	
!ма/	— мáти (мáю) (дієсл.)
			
!мах/	— махáти
/маш/	— замáшистий

!меж/	— межá
/між/	— промíжний	
/меж'ж'/ — безмéжжя

!мер/	— мéртвий
мр/	— мру
/мир/	— умирáти

!мес/	— мести́	
мет/	— мéтений
/міт/	— замітáти
/мі/	— замíв
/ме/	— замелá
	
!мик/	— ми́кати	
мич/	— ми́чу

!/мик/	— відмикáти	
/мк/	— замкнýти	
/мок	— замóк
/моч/	— замóчок	
/мч/	— замчи́ще
/мил/	— помили́тися
/миль/	— непоми́льний

!мисл/	— ми́слити
/мисел/	— дóмисел
/мишл'/	— помишля́ти 

!мить	— мить
мит'т'/	— ми́ттю	

!миш/	— ми́ша	

!мідь	— мідь
мід'д'	— мíддю	

!міс/	— міси́ти
міш/	— мішý	

!міст/	— місти́ти
/міс/	— сумíсний 
/міщ/	— заміщáти 
/міщ/	— суміщáти 
місц/	— мíсце	
місць	— місць	

!міст/	— мíсто	
місь/	— міськи́й

!міст	— міст	
мост/	— мóстом
/мощ/	— вимóщувати 
/міщ/	— розміщáти 

!місяць	— мíсяць
місяц/	— мíсяцевий 
місяч/	— місячéнько 

!/міт/	— відмíтити 
/міть/	— відмíть
/міч/	— помічáти 

!міх	— міх	
міс'/	— у мíсі
міш/	— мішóк	

!міц/	— міцни́й
міць/	— міць	
міц'ц'/	— мíццю	

!мл/	— мла	
імл/	— імлá	

!мног/	— многогрáнний 
множ/	— мнóжити

!мов/	— мóвити
/мовл'/	— вимовля́ти 
/мовл/	— ви́мовлений 
/мовк/	— замовкáти 
/мовч/	— замовчý

!могут/	— могýтній 
могут'т'/ — могýття
могуть	— могýть
	
!мозок	— мóзок
мозк/	— мóзковий
мозоч/	— мóзочок
	
!мозоль/ — мозóльний
мозол/	— мозóлити
	
!мок/	— мóкнути
моч/	— мочи́ти
	
!мол/	— моли́ти
мол'/	— молю́
/міль/	— богомíльний
/міл'л'/	— богомíлля

!моло/	— молóти
/мел/	— ви́мелений
мель/	— мéльник	
/мол/	— недомóл
мл/	— мли́во
	
!молод/	— молоди́й
/молодж/ — відмолóджувати
молодь	— мóлодь
молод'д'/ — мóлоддю
молож/	— моложáвий

!молок/  — молокó
молоц'/	— у молоцí	
молоч/	— молóчний

!молот/	— молоти́ти
молоч/	— молочý
молоть/	— молотьбá

!мороз	— морóз	
мороз'/	— морóзять
морож/	— морóжений
/морозь	— пáморозь
/мороз'з'/ — пáмороззю

!морок/	— морóка
мороц'/	— морóці
/мороч/	— заморóчити
	
!/моршк/ — змóршка
/моршц/	— змóршці
/морщ/	— змóрщити

!мох	— мох	 
/мш/	— замши́тися
 
!мрій/	— мрійли́вий

!мст/	— мсти́ти
/мщ/	— пóмщений 

!музик/	— мýзика
музиц'/	— мýзиці
музич/	— музи́чний 

!мук/	— мýка (страждання)
муц'/	— у мýці
муч/	— мýчити

!мук/	— мукá (борошно)
муц'/	— муцí	
муч/	— мучни́й

!мус/	— мýсити
муш/	— мýшу	

!мух/	— мýха	
мус'/	— на мýсі
муш/	— мýшка	

!м’я/	— м’я́ти	
мн/	— мну	
/мин/	— виминáти 

!нагород/ — нагороди́ти 
нагород'/ — нагорóдять 
нагородж/ — нагороджý 

!над/	— нáдити
/надж/	— принáджу 

!насін/	— насіни́на  
насін'н'/ — насíння  

!небог/	— небóга
небоз/	— небóзі
небіж	— нéбíж	 
небож/	— небóже

!ненавид'/ — ненáвидять 
ненавидж/ — ненави́джу		
ненависть — ненáвисть 
ненавис/ — ненáвисний 

!низ/	— ни́зом	 
низь/	— низьки́й
/ниж/	— зни́жувати 
/низ'з'/ — пони́ззя 

!нирк/	— ниркови́й  
нироч/	— ни́рочка
нирц'/	— у ни́рці
	
!нит/	— ни́тка
нить	— нить
нит'т'/	— ни́ттю
	
!ніготь	— нíготь
нігт/	— нíгтем
	
!ніж	— ніж
нож/	— ножá
	
!ніс	— ніс	
нос/	— носáтий	
/ніс'с'/ — перенíсся

!ніч/	— ніч	
ноч/	— ночувáти
ніч'ч'/	— нíччю

!нов/	— нови́й
/новл'/	— віднóвлювати	
/новл/	— віднóвлений

!ног/	— ногá
ноз'/	— на нозí
ніж/	— нíжка
/ніж'ж'/ — піднíжжя

!нос/	— носи́ти
нос'/	— нóсять
нош/	— нóшений
нес/	— нести́	  
ніс	— ніс
 
!нуд/	— нýдитися
/нудж/	— винýджувати
нудь/	— нудьгá
	  
!/ня/	— відня́ти	  
/єм/	— від’є́мний
/нім/	— віднімáти	  
/йм/	— відіймáти
/йом	— прийóм

!обід	— обíд
/обід'д'/ — передобíддя

!образ/	— обрáзити   
ображ/ 	— ображáти
 
!образ	— óбраз
/ображ/	— зображáти
 
!обух	— обýх	   
обус'/	— на обýсі	   
обуш/	— обýшóк

!овес	— овéс	
вівс/	— вівсá	
вівс'/	— вівся́ний 
овс/	— овси́сько 

!огірок	— огірóк
огірк/	— огіркá
огіроч/	— огірóчок 

!один	— оди́н	
одн/	— одногó

!ок/	— óко
оц'/	— на óці
оч/	— óчний	
віч/	— вíчко	

!олен/	— олéни́на
олень	— óлень	

!олівець — олівéць
олівц/	— олівцéм
олівц'/	— олівця́
олівч/	— олíвчик

!опік/	— опíка	
опіц'/	— в опíці
/опіч/	— підопíчний 

!орд/	— ордá	

!орел	— орéл	
орл/	— орлá	
орл'/	— орля́	

!ос/	— осá	

!осел	— осéл	
осл/	— ослá	

!осик/	— оси́ка	
осиц'/	— на оси́ці
осич/	— оси́чник

!осінь	— óсінь	
осін'н'/ — óсінню
/осен/	— восени́

!особ/	— осóба	
/особл'/ — відособля́ти 

!острів/ — óстрів
остров/	— óстрова

!очерет	— очерéт
очерет'/ — очеретя́ний 
	
!павук	— павýк
павуч/	— павучóк
павуч'ч'/ — павýччя
павут/	— павути́на
	
!пагін	— пáгін	
пагон/	— пáгона 

!пад/	— пáдати
/пас/	— упáсти	
/па/	— упáв

!падь	— падь	
пад'д'/	— пáддю

!пазух/	— пáзуха
пазус'/	— у пáзусі	
пазуш/	— пáзушний

!пак/	— пáка	
пац'/	— у пáці	
пач/	— пáчка
	
!пакост/ — пáкостити
пакощ/	— пáкощу
пакість	— пáкість	
пакіс/	— пáкісний

!пал/	— пали́ти
паль/	— запальни́й

!/пал/	— безпáлий
паль/	— пáльця

!пам’ять — пáм’ять
памят'т'/ — пáм’яттю
пам’ят/	— пáм’ятний

!папір	— папíр
папер/	— папéру
	
!пар/	— пáрити
пар/	— парувáти (про рідину)
	
!пас/	— пáсти	
паш/	— пáша

!пасік/	— пáсіка
пасіц'/	— на пáсіці	
пасіч/	— пáсічник
	
!патик	— пати́к	
патич/	— патичóк
патич'ч'/ — пати́ччя

!певн/	— пéвний
певен	— пéвен
/певн'/	— запевня́ти 

!пек/	— пекти́	
печ/	— печý 	
/пік/	— опікáти

!піч	— піч	
печ/	— на пéчі
піч'ч'/	— пíччю	

!пень/	— пеньóк
пн'/	— пня	
пн/	— пнем

!пер/	— перó	
пір/	— пíритися 

!перед	— перéд	
/передж/ — поперéджувати 

!/перек	— поперéк	
переч/	— перéчити 

!перепел — пéрепел
перепіл/ — перепíлка 

!перець	— пéрець
перц/	— перцéвий 
перч/	— пéрчик	

!пес	— пес		
пес'/	— пéсячий
пс/	— пса

!пест/	— пéстити
пест'/	— пéстять
пещ/	— пéщений

!петл'/	— петля́	
петель/	— петéлька 

!печат/	— печáтка
печать	— печáть
печат'т'/ — печáттю 

!печінк/ — печíнка 
печінц'/ — печíнці 
печіноч/ — печíночник 

!пи/	— пи́ти	
п/	— п’ю	
пой/	— пої́ти	

!пил/	— пи́лом	
пил'/	— пилю́ка

!пил/	— пилá	
пил'/	— пи́лять

!пер/	— пéрти	
пр/	— пру
/пир/	— випирáти
/пір	— напíр	
/пор/	— напóром

!пиріг	— пирíг	
пирог/	— пирогá
пиріж/	— пиріжóк	
пироз'/	— у пирозí

!пис/	— писáти	
пиш/	— пишý
пись/	— письмéнний

!писк	— писк
пис/	— пи́снути
пищ/	— пищáти

!пит/	— питáти

!пих	— пихá	
пиш/	— пишáтися

!/пих/	— випихáти	
пх/	— пхнýти

!пі/	— пíсня, співáти

!південь — пíвдень (частина світу)
півдн'/	— пíвдня	
півден/	— півдéнний
	
!північ	— пíвніч
півноч/	— пíвночі
	
!пізн/	— пíзній
/пізн'/	— спізню́ся

!пін/	— пíна
пін'/	— пíняться
	
!пісок	— пісóк
піск/	— піскувáтий
пісоч/	— пісóчок
піщ/	— піщáний

!піх/	— піхóта
піш/	— пíший

!плав/	— плáвити
плавл'/	— плáвлю
плавл/	— плáвлений
	
!плак/	— плáкати
плач/	— плáчу
	
!плат/	— плати́ти
плач/	— плачý

!плем’/	— плéм’я
плем/	— племінни́й 

!плес/	— плести́  
плет/	— плетý	
/пліт/	— заплітáти 
плот/	— на плóті  
/плі/	— заплíв
/пле/	— заплелá

!плеск/	— плéскати  
плещ/	— плéщу	 
/пліск/	— виплíскувати 
плес/	— плеснýти 

!плеч/	— плечé	  
пліч/	— плíчко
/пліч'ч'/ — заплíччя 

!плід	— плід	
плод/	— плоди́ти
плодж/	— плоджý

!плоскінь — плоскíнь 
плоскін'н'/ — плоскíнню 
плоскін/ — плоскíнний 

!плуг/	— плýгом
плуз'/	— у плýзі
плуж/	— плужóк

!плю/	— плю́нути
плюв/	— плювóк	
/пльов/	— запльóваний 

!плям/	— пля́ма	  
плямл'/	— пля́млять 
/плямл/	— запля́млений 

!повід/	— повідáти  
/повідь	— вíдповідь  
/повід'д'/ — вíдповіддю 
пові/	— повíв	 

!повн/	— пóвний
повен	— пóвен	

!поган/	— погáний
погань	— пóгань
поган'н'/ — пóганню 

!подушк/ — подýшка
подущц'/ — подýшці
подушок	— подушóк
подушеч/ — подýшечка 
	  
!/пок/	— спóкій
/поч/	— відпочи́ти
  
!пол/	— пóле
поль/	— польови́й
/піль/	— двопíльний
/піл'л'/	— двопíлля
	  
!пол/	— полови́на	  
пів	— пів

!полиц'/ — поли́ця
полич/	— поли́чка

!полк	— полк
/полч/	— однополчáнин

!поло/	— полóти	  
пол'/	— полю́
/пол/	— спóлений
  
!полоск/ — полоскáти	  
полощ/	— полощý 
/поліск/ — виполíскувати
полос/	— полоснýти

!полотн/ — полотнó
полотен/ — полотéнце
	  
!полох/	— полóхати	  
/полос/	— спóлосі	  
полош/	— полоши́ти
	  
!понят'т'/ — поня́ття
понят/ 	— понятíйний

!попел/	— попели́ти
попіл	— пóпіл
попіль/	— попільни́ця

!пор/	— порá

!пор/	— пóри (отвори)

!поріг	— порíг
порог/	— порóгом
пороз'/	— на порóзі	  
поріж/	— поріжóк
  
!порок	— порóк  
пороц'/	— порóці  
пороч/	— порóчити
 
!порох	— пóрох  
порос'/	— у пóросі  
порош/	— пороши́ти
	  
!пот/	— пóтом
піт	— піт

!потом/	— потóмок
потім	— пóтім	 

!пр/	— прáти	  
пер/	— перý	 
/пир/	— випирáти

!прав/	— прáвити
правл'/	— прáвлю
правл/	— прáвлений

!правд/	— прáвда
/правдж/ — спрáвджувати	

!/праць/ — спрацьóваний	
прац/	— працездáтний

!предмет/ — предмéтний
/предмеч/ — опредмéчений

!приск/	— при́скати
прис/	— при́снути

!присяг/ — присягáти	
присяз'/ — на прися́зі	
присяж/	— прися́жний

!прода/	— продавáти
/прод/	— випрóдувати	

!промен/ — промени́тися
промінь	— прóмінь
промін'н'/ — промíння		
промен'/ — променя́стий
промін/	— промíнчик

!прос/	— прóсо	 
пріс/	— прíснище

!прост/	— прости́й
/прощ/	— спрóщений	

!прост/	— прости́ти
прост'/	— простя́ть
прощ/	— прощáти

!простор/ — простóрий	
простір	— прóстір

!прох/	— прохáти
прос/	— проси́ти
/прош/	— запрóшувати

!прут/	— прýтик
прут'т'/ — прýття

!пруч/	— пручáтися
	
!/пряг/	— запрягáти
/пріг	— запрíг
/пряж/	— запря́жений
       
!прям/	— прями́й     
/прямл'/ — випрямля́ти 
/прямл/	— ви́прямлений
	
!пряс/	— пря́сти	        
пряд/	— прядý 	        
пря/	— пря́ло
	
!псу/	— псувáти	        
/псов/	— зіпсóваний

!пт/	— птах

!/пук/	— ви́пуклий
	
!пуск/	— пускáти
/пущ/	— ви́пущений
/пуст/	— ви́пустити
	
!пух/	— пухнáстий	
пуш/	— пуши́ти

!/п’я/	— ви́п’ясти
/пин/	— запинáти	
/пн/	— запнýти
	
!п’ят/	— п’я́тий
п’ять	— п’ять
	
!пшениц'/ — пшени́ця        
пшенич/	— пшени́чний
	
!рад/	— рáдити	
радь/	— рáдьте     
радж/	— рáджу
	
!раз/	— рази́ти	
/раж/	— вражáти

!рак/	— рáки	
рач/	— рáчки
	
!рам/	— рáма	
/рамл'/	— обрамля́ти
/рамл/	— обрáмлення
	
!рам’/	— рáм’я	
рам/	— рамéна
	
!рв/	— рвáти	
/рив/	— виривáти
	        
!рон/	— рони́ти        
рон'/	— рóнять

!ран/	— рáнок	
/ран'н'/ — зрáння
	        
!рев/	— ревíти
ревл'/	— ревля́ть

!регот/	— реготáти 
регоч/	— регочý
регіт	— рéгіт	

!/рек/	— зректи́ся 
/рік/	— вирікáтися 
/реч/	— ви́речуся 

!/річ'ч'/ — просторíччя 

!ремінь	— рéмінь
ремін'н'/ — ремíння  
ремен'/	— рéменя

!решет/	— рéшето
решіт/	— решíтка

!ріп/	— рíпа	
реп/	— рéпаний

!річ	— річ	
річ'ч'/	— рíччю	
реч/	— рéчі	

!рж/	— ржавíти
ірж/	— іржавíти 

!риб/	— ри́ба	 
/рибл'/	— зари́блювати 

!/рив/	— виривáти  
рв/	— рвáти	

!рик	— рик	
рич/	— ричáти

!рил/	— ри́ло	
риль/	— ри́льце

!рип'/	— рипíти
рипл'/	— рипля́ть

!рис/	— рисувáти 

!рід/	— рідки́й	
/рідж/	— зрíджувати 
різ/	— рíзати
ріж/	— рíжу	

!рік	— рік
рок/	— рóку	
роц/	— у рóці
/річ/	— багаторíчний 
/ріш/	— торíшній

!ріль/	— рільни́к	
ріл'л'/	— рілля́	
 
!/рн/	— пірнáти
/рин/	— виринáти

!роб/	— роби́ти	
/ріб	— ви́ріб
робл/	— рóблений
робл'/	— роблю́

!рог/	— рогови́й 
роз/	— в рóзі
ріг	— ріг	 
/ріж/	— нарíжний

!род/	— роди́ти	
род'/	— рóдять	
/родж/	— нарóдження	
/рож/	— урожáй

!рід	— рід	
/рід'д'/ — порíддя

!рой/	— рої́тися
рій	— рій

!рос/	— росá
/рош/	— зрóшувати

!/рост/	— виростáти
ріст	— ріст
рос/	— рóслий

!/рост/	— ви́ростити
/рощ/	— ви́рощу

!руб/	— рубáти	
/рубл'/	— вирýблювати

!руйн/	— руйнувáти	
руї́н/	— руї́на
	
!рук/	— рукá	
руц'/	— руцí
руч/	— рýченька
/руч'ч'/ — порýччя

!рух/	— рýхати	
рус/	— у рýсі
руш/	— рýшити
	
!ряд	— ряд

!ряд/	— ряди́ти	
рядж/	— ряджý

!рят/	— рятувáти
		
!сагайдак	— сагайдáк
сагайдач/	— сагайдáчний

!сад/	— сади́ти
сад'/	— сáдять	
садж/	— саджáти	

!сал/	— сáло	
саль/	— сальцé	

!сап/	— сáпати (дихати)	
соп/	— сопíти	
сопл'/	— сопля́ть	

!сверб/	— свербíти 
свербл'/	— свербля́ть 

!свин'/	— свиня́	
свин/	— свини́на	

!свист/	— свистáти 
свищ/	— свищý	
свис/	— сви́снути 

!свідок	— свíдок	
свідк/	— свíдка	
свідч/	— свíдчити 

!світ/	— світи́ти	
свіч/	— свічý	

!/свой/	— засвóювати 
свій/	— свíйський 

!свят/	— святи́ти	
свяч/	— свячý	

!сел/	— селя́нський 
сіль/	— сільськи́й 

!секрет	— секрéт	
/секреч/	— засекрéчувати 

!сем/	— семилíток 
сім/	— сíмка	
сьом/	— сьóмий	

!серд/	— сердéчний 
сер/	— сéрце	

!серд/	— серди́тий 
сердж/	— сéрджуся 

!серед/	— середи́на 
/серед'д'/	— осéреддя 

!сид/	— сиди́ть	
сид'/	— сидя́ть	
сидж/	— сиджý 	
сяд/	— ся́ду	
сіс/	— сíсти	
сід/	— сідáти	
сі/	— сів	

!сил/	— си́ла
силь/	— си́льний
/сил'л'/	— зуси́лля

!/сил/	— висилáти
/силь/	— поси́льний
/сл/	— заслáти
шл'/	— шлю
/шл/	— пошлемó

!синь/	— синьоóкий
син'н'/	— си́нню

!сип/	— си́пати
сипл'/	— си́плять

!/сис/	— висисáти
сс/	— ссáти
сос/	— соскóвий

!сирот/	— сиротá
сироч/	— осирочý
сиріт/	— сирíтка

!сит/	— си́тий
/сит'/	— наси́тять
/сич/	— наси́чений

!сит/	— си́то

!/сих/	— висихáти
сох/	— сóхнути
сух/	— сухи́й
суш/	— суши́ти
сх/	— схнýти

!сідл/	— сідлó
сідель/	— сідéльце

!сік/	— сікти́
січ/	— січý

!сім/	— сімóм
сем/	— семи́

!сін/	— сíни

!сіт/	— сíтка
сіть	— сіть
сіт'т'/	— сíттю

!сказ/	— скази́тися
скаж/	— скажéний

!скак/	— скакáти
скач/	— скачý
скок/	— скóком
скоч/	— скóчити	
скік	— скік	

!скарг/	— скáрга	
скарз'/	— скáрзі	
скарж/	— скáржитися	

!скл/	— скло	
скл'/	— скляни́й	
скель/	— скéльце	
стекл/	— стéкла	
стекол	— стéкол	

!скород/	— скорóдити	
скород'/	— скорóдять	
скородж/	— скорóджу	

!скреб/	— скребти́	
/скріб/	— вискрібáти	
скребл'/	— скребля́ть	
шкреб/	— шкребти́	
шкряб/	— шкря́бати	

!скринь/	— скри́нька	
скрин/	— скри́нечка	

!скрип/	— скрипýн	
скрипл'/	— скрипля́ть	

!скуп/	— скупи́й	
скупл'/	— скýпляться	

!слаб/	— слаби́й	
/слабл'/	— ослабля́ти	
/слабл/	— ослáблений	

!слав/	— слáва	
/славл'/	— виславля́ти	
/славл/	— ослáвлений	

!/слиз/	— вислизáти	
слизь	— слизь	
слиз'з'/	— сли́ззю	

!слин/	— сли́на	
слинь/	— слинькó	

!слід/	— сліди́ти	
/слід'/	— ви́слідять	
слідж/	— сліджý	

!сліп/	— сліпи́ти	
/сліпл'/	— заслíплювати	
/сліпл/	— заслíплений	

!слов/	— слóво	
слів/	— слівцé	
/словл'/	— вислóвлювати	
/словл/	— ви́словлений

!/слон/	— заслони́ти
/слін	— заслíн

!слуг/	— слугá
слуз'/	— у слузí
служ/	— служи́ти

!слух/	— слýхати
/слуш/	— послýшний

!сльоз/	— сльозá
сліз	— сліз
слізь/	— слізьми́

!смак/	— смакувáти
смач/	— смачни́й

!смал/	— смали́ти

!смерек/	— смерéка
смерец/	— смерéці
смереч/	— смерéчка
смеріч/	— смерíчка
смереч'ч'/	— смерéччя
смеріч ч'/	— смерíччя

!сміт/	— сміти́ти
сміт'т'/	— сміття́
сміч/	— смічý

!смокт/	— смоктáти
смокч/	— смокчý

!смол/	— смолá
смол'/	— смоляни́й

!смуг/	— смýга
смуз/	— у смýзі
смуж/	— смýжка

!/смут/	— засмути́ти
смут'/	— смутя́ть
/смуч/	— засмучý

!снаг/	— снагá
сназ'/	— на сназí
/снаж/	— ви́снажений

!/снаст/	— оснасти́ти
/снащ/	— оснáщений
снасть	— снасть

!сніг	— сніг
сніж/	— сніжóк
/сніж'ж'/	— безснíжжя

!сніп	— сніп
сноп/	— снопá	

!/снов/	— заснóваний	
сну/	— снувáти	

!собак/	— собáка	
собац'/	— собáці	
собач/	— собáчка	

!совість	— сóвість	
совіс/	— сóвісний	

!сок/	— сóком	
сік	— сік	
соч/	— сочи́ти	

!сол/	— соли́ти	
сіль	— сіль	
сіл'л'/	— сíллю	

!солов/	— соловéйко	
соловй/	— солов’ї́ний	

!солод/	— солоди́ти	
солодж/	— солоджý	

!сон	— сон	
/син/	— засинáти	
/сн/	— заснýти	
/сон'н'/	— безсóння	

!сорок/	— сорóка	
сороц'/	— сорóці	
сороч/	— сороченя́	

!сором	— сóром	
соромл'/	— сорóмляться	
/соромл/	— засорóмлений	

!сот/	— сóтий	
ст/	— сто	

!сп/	— спáти	
спл'/	— сплю	
/сипл/	— висипля́тися	

!спід	— спід	
спод/	— спóду	

!спіл/	— спíлка	
спіль/	— спíльний	

!спонук/	— спонукáти	
спонуц'/	— спонýці	

!спор/	— спóрити	
спір/	— спíрний	

!спосіб	— спóсіб	
способ/	— спóсобом

!справ/	— спрáвити
справл/	— справля́ти

!/срібл/	— посрібли́ти
/срібл'/	— посрібля́ти

!став/	— стáвити
ставл/	— стáвлю
/ставл/	— постáвлений

!стал/	— стали́ти
сталь	— сталь
стал'л'/	— стáллю

!стебл/	— стеблó
стебел	— стéбел
стебель/	— стебéльце

!стегн/	— стегнó
стегон	— стéгон
стеген/	— стегéнце

!стел/	— стели́ти
/стил/	— застилáти
сл/	— слáти

!стерег/	— стерегти́
стереж/	— стережý
/стеріг/	— застерігáти

!стіг	— стіг
стог/	— стоги́
стоз'/	— у стóзі
стіж/	— стіжóк	

!стол/	— стóлик
стіл	— стіл
/стіль/	— застíльний
/стіл'л'/	— застíлля

!стогн/	— стогнáти
стогон/	— стóгону
стогін	— стóгін

!страх	— страх
страс/	— у стрáсі
страш/	— страши́ти

!/стрел/	— застрéлений
стрель/	— стрéльнути
стріл/	— стрілá
стріль/	— стрільбá

!стриг/	— стри́гти
стриж/	— стри́жений

!стріх/	— стрíха
стріс'/	— стрíсі	
/стріш/	— острíшок	

!строй/	— стройови́й	
стрій	— стрій	

!строк	— строк	
строк/	— строчи́ти	

!студ/	— студи́ти	
студж/	— студжý	

!ступ/	— ступи́ти	
ступл'/	— ступлю́	
/ступл/	— застýплений	

!су/	— сýнути	
сув/	— сувáти	
сов/	— сóвати	

!суд/	— судити	
судж/	— суджý	
суд'д'/	— суддя́	

!судорог/	— сýдорога	
судороз'/	— сýдорозі	
судорож/	— сýдорожний	

!сук/	— сукáти	
суч/	— сучý	

!сук	— сук	
суч/	— сучóк	
суч'ч'/	— сýччя	

!сукн/	— сукнó	
сукон/	— сукóнний	

!суп/	— сýпитися	
супл'/	— сýпляться	
/супл/	— насýплений	

!сурм/	— сурми́ти	
сурмл'/	— сурмля́ть	
сурмл/	— сýрмлення	

!сусід	— сусíд	

!суть	— суть	
сут'т'/	— суттю	

!схід	— схід (частина світу)	
сход/	— на сході	

!сяг/	— сягáти	
/сяж/	— недосяжний	

!сьорб/	— сьóрбáти	

!тісн/	— тісни́й
тісн'/	— тісня́вий

!та/	— тáнути
тай/	— тáяти

!талан	— талáн
талан'н'/	— безталáння

!тверд/	— тверди́й
твердж/	— тверджý

!твор/	— твори́ти
твір	— твір

!тек/	— текти́
теч/	— течé
/тік/	— витікáти
/ток/	— протóка
/тоц'/	— протóці
/тіч/	— стічни́й

!тел'/	— теля́
тел/	— тели́ця

!тем/	— тéмний
тьм/	— тьмá

!тер/	— тéрти
тр/	— тру
/тир/	— витирáти

!тереб/	— тереби́ти
теребл'/	— терéблять
теребл/	— терéблений

!терн/	— терни́на
терен	— тéрен
терн'/	— тéрня

!терп/	— терпи́ть
терпл'/	— терпля́ть

!тес/	— тесáти
/тіс/	— витíсувати
теш/	— тешý

!тиждень	— ти́ждень
тижн/	— тижнéвий

!тик/	— ти́кати	
тич/	— ти́чу
тиць/	— ти́цьнути
тк/	— ткнýти

!тил/	— тилови́й
тиль/	— ти́льний

!тин	— тин
/тин'н'/	— попідти́нню	

!тиск	— тиск	
тис/	— ти́снути	

!тих/	— ти́хий	
тиш/	— ти́ша	
тиш'ш'/	— зати́шшя	

!/ті/	— затівáти	
/тій/	— затíяти	

!тіл/	— тíло	
/тіль/	— натíльний	

!тінь	— тінь	
тін'н'/	— тíнню	
тін/	— тіни́стий	

!/тіх/	— потíха	
/тіс/	— потíсі	
тіш/	— тíшити	

!тк/	— ткáти	
тч/	— тчу	

!тлум/	— тлуми́ти 
тлумл'/	— тлумлю́	
/тлумл/	— ви́тлумлений	

!товариш	— товáриш	
товарись/	— товари́ський	

!товк/	— товкти́	
товч/	— тóвчений	

!товп/	— тóвпитися	
товпл'/	— тóвпляться	

!товст/	— товсти́й	
товщ/	— тóвща	

!ток/	— тóком	
тоц'/	— на тóці	
тік	— тік	

!ток/	— тóкар	
точ/	— точи́ти	

!/том/	— утоми́тися	
/томл'/	— втóмлюватися	
/томл/	— втóмлений	

!тон/	— тонки́й	

!топ/	— топи́ти (у воді)	
топл'/	— топлю́	
/топл/	— втóплений	
то/	— тонýти	

!топол/	— тополи́ний	
тополь/	— топóлька

!топт/	— топтáти
топч/	— топчý

!торок/	— тороки́
тороч/	— торочи́ти

!трав/	— трави́ти
травл'/	— травлю́
травл/	— трáвлений

!трап/	— трáпитися
трапл'/	— трáплюся

!трат/	— трáтити
трать	— трать
трач/	— трáчу

!треб/	— трéба
/тріб/	— потрíбний

!тремт/	— тремтíти
тремч/	— тремчý

!тривог/	— тривóга
тривоз'/	— тривóзі
тривож/	— тривóжити

!тріск/	— трíскати
тріщ/	— тріщáти
тріс/	— трíснути
трісь	— трісь

!труд/	— труди́тися
трудж/	— труджýся

!трут/	— трýтити
труч/	— тручáти

!трус/	— труси́ти
труш/	— трушý

!туг/	— туги́й
/туз/	— в потýзі
/туж/	— потýжний

!туг/	— тýга
туз'/	— у тýзі
туж/	— тужи́ти

!туп/	— тупи́й
/тупл'/	— притýплювати
/тупл/	— притýплений

!турб/	— турбóта

!/тух/	— затухáти
туш/	— туши́ти

!тхір	— тхір
тхор/	— тхорá	

!тюрм/	— тюрмá		
тюрем	— тю́рем	

!тя/	— тя́ти	
/тин/	— витинáти	
тн/	— тну		
/т/	— ви́тнути	

!тяг/	— тя́га	
тяз'/	— на тя́зі	

!тяг/	— тягáр	
тяж/	— тяжки́й	

!тям/	— тя́мити	
тямл'/	— тя́млю	
/тямл/	— затя́млений	

!тятив/	— тятивá	

!убог/	— убóгий	
/убож/	— зубóжувати	
вбог/	— вбóгий	
вбож/	— вбóжество	

!удар/	— удáрити	
вдар/	— вдáрити	

!удов/	— удовá	
удів/	— удівéць	
вдов/	— вдови́ний	
вдів/	— вдівéць	

!узор/	— узóри	
взір/	— взірéць	

!узя/	— узя́ти	
взя/	— взя́ти	
візьм/	— візьмéмо	

!уч/	— учи́ти	
вч/	— вчи́ти	
/ук	— нéук	
/уц/	— нéуцтво	

!ум/	— умíти	
вм/	— вмíти	

!урок	— урóк	
уроц'/	— на урóці	
/уроч/	— поурóчний	

!уряд	— уряди́ти	
урядж/	— уря́джений

!уст/	— устá	
ус/	— ýсний

!форм/	— фóрма
/формл/	— офóрмлений
/формл'/	— оформля́ти

!хвал/	— хвали́ти
хваль/	— хвалькó

!хвил'/	— хви́ля
хвил/	— хви́лею

!хвил/	— хвили́на
хвиль/	— хви́лька

!/хвиль/	— схвильóваний

!хвіст	— хвіст
хвост/	— хвостáтий
/хвіст'/	— охвíстя

!хиб/	— хи́ба
/хибл'/	— схи́блю
/хибл/	— схи́блений

!хил/	— хили́ти
/хиль/	— схи́льний

!хлюск/	— хлю́скати
хлющ/	— хлющ

!хмар/	— хмáра

!хмел/	— хмелем
хміль/	— хмільни́й

!хмур/	— хмýритися

!хобот	— хóбот
хобот'т'/	— хобóття

!хов/	— ховáти

!ход/	— ходи́ти
ходж/	— ходжý
хід	— хід
/хідь	— безви́хідь
ходь/	— ходьбá
/хож/	— підхóжий

!холод/	— холóдний
/холодж/	— вихолóджувати
холо/	— холóнути

!/хоп/	— ухопи́ти
хап/	— хапáти	
/хопл'/	— вхоплю́
/хопл/	— вхóплений

!хорон/	— хорони́ти	
хорон/	— хорóнять	

!хот'/	— хотя́ть	
хоч/	— хóчу	
/хіть	— нéхіть	

!хребет	— хребéт	
хребт/	— хребтá	

!хрест/	— хрести́ти		
хрест/	— хрéстять	
хрещ/	— хрещéний	
хрес/	— хрéсний	

!хрін	— хрін	
хрон/	— хрóну	

!хроп/	— хропти́	
храп	— храп	

!худ/	— худи́й	
худ/	— худю́щий	

!худоб/	— худóба	
худіб/	— худíбка	

!хутор/	— хуторéць	
хутір	— хýтір	

!цар	— цар	
цар'/	— царювáти	

!цвірін/	— цвірінчáти	
цвірінь/	— цвірíнькати	

!цвіс/	— цвісти́	
цвіт/	— цвітáстий	
/цві/	— зацвíв	

!цвях	— цвях	
цвяш/	— цвя́шок	

!цегл/	— цегли́на	
цегель/	— цегéльний	

!цибуль/	— цибýлька	
цибул/	— цибули́на	

!цід/	— ціди́ти	
цідж/	— ціджý	

!цікав/	— цікáвий	
цікавл'/ — цікáвлюся	
/цікавл/ — зацікáвлений	

!ціль	— ціль	
ціл'л'/	— цíллю	

!/ціп/	— зцíпити
/ціпл'/	— зціпля́ти
/ціпл/	— зцíплений

!цукор	— цýкор
цукр/	— цýкру

!/цуп/	— поцýпити
/цупл'/	— поцýплю
/цупл/	— поцýплений

!/ча/	— почáти
/чин/	— починáти
/чн/	— почнý

!чад/	— чадíти

!чай/	— чáйка

!/чал/	— причáлити
/чал'/	— причáлювати

!част/	— чáстий
/чащ/	— учащáти

!чван/	— чвáнитися
чвань/	— чванькó

!чверть	— чверть
чверт/	— чвéртка

!чек/	— чекáти
/чік/	— вичíкувати

!/чеп/	— зачепи́ти
/чепл'/	— зачéплять
/чепл/	— причéплений
чіп/	— чіпáти
чіпл'/	— чіпля́ти
/чіпл/	— причíплений

!червон/	— червóний
червінь	— червíнь
червін'н'/	— червíнню	

!черг/	— чéрга
черз'/	— чéрзі

!череп	— чéреп
череп/	— черéп’я

!черешн'/	— черéшня
черешн/	— черéшневий
черешень/	— черéшенька

!чес/	— чесáти
/чіс/	— зачíсувати
чеш/	— чешý

!честь	— честь
/чест/	— нечести́вий	
чес/	— чéсний	

!/чин/	— зачиня́ти	

!числ/	— числó	
числ'/	— чи́слять	
числ/	— чи́слити	
чисель/	— чисéльний	

!чист/	— чи́стити	
чищ/	— чи́щу	
чисть/	— чистьóха	

!чобіт	— чóбіт	
чобот/	— чóбота	
чобіть/	— чобітьми́	

!човен	— чóвен	
човн/	— човнá	

!чоло	— чолó	
чіль/	— чíльний	

!чоловік	— чоловíк	
чоловіч/	— чоловíчний	
чоловіц/	— чоловíцтво	
чоловй/	— чолов’я́га	

!чорн/	— чóрний	
черн/	— чернéтка	

!чотир/	— чоти́ри	
четвер/	— чéтверо	

!чу/	— чýти	
чуй/	— чýйний	

!шабл'/	— шáбля	
шабл/	— шáблею	
шабель/	— шабéлька	

!шапк/	— шáпка		
шапок	— шапóк	
шапц'/	— шáпці	
шапоч/	— шáпочка	

!шелест'/	— шелестя́ть	
шелест	— шéлест	
шелес/	— шелéснути	

!шепот/	— шепотáти	
шепоч/	— шепочý	
шепіт	— шéпіт	
шепт/	— шептáти
шепч/	— шепчý

!шершень	— шéршень
шершн'/	— шéршня

!шип/	— шипíти
шипл'/	— шипля́ть

!шкод/	— шкóда
/шкодж/	— пошкóджений
шкід/	— шкідли́вий

!школ/	— шкóла
шкіль/	— шкільни́й
шкіл/	— шкíлка

!шкур/	— шкури́нка
шкір/	— шкíрка
шкор/	— шкори́нка

!шмат/	— шмати́на
шмат'т'/	— шмáття

!шов	— шов
шв/	— швець, швáчка
шев/	— шéвський

!шорст/	— шорстки́й

!шост/	— шóстий
шість	— шість
шест/	— шести́

/шпил/	— зашпи́лити
шпиль/	— шпи́лька

!штук/	— штýка
штуц'/	— штýці
штуч/	— штýчка

!шум/	— шумíти
шумл'/	— шумля́ть

!щабель	— щабéль
щабл/	— щабли́на

!щад/	— щади́ти
щадж/	— щаджý

!щаст/	— щасти́ти
щас/	— щасли́вий

!щебет/	— щебетáти
щебеч/	— щебéче

!щем/	— щемíти	
щемл'/	— щемля́ть

!щеп/	— щепи́ти
щепл'/	— щéплять
/щепл/	— защéплений		

!щерб/	— щерби́ти
щербл'/	— щербля́ть	
/щербл/	— защéрблений	

!щіл/	— щіли́на	
щіль/	— щíльний	

!щітк/	— щíтка	
щіток	— щíток	
щітц'/	— щíтці	
щіточ/	— щíточка

!щок/	— щокá	
щік	— щік	
щіч/	— щíчка	
щоц'/	— щоцí	

!щук/	— щýка	
щуц'/	— щýці	
щуч/	— щýчий	

!щул/	— щýлити
щул'/	— щýлять	

!юд/	— ю́дити	
юдь/	— ю́дьте	
юдж/	— ю́джу	

!юрб/	— юрбá	
юрбл'/	— ю́рбляться

!яв/	— яви́тися
/явл'/	— з’явля́тися

!явір	— я́вір
явор/	— явори́на

!ягод/	— я́года

!ядр/	— ядрó	
ядер/	— я́дерний

!яйц/	— яйцé
яєць	— яє́ць

!я́кір	— якір
якор'/	— я́коря

!якість	— я́кість
якост'/	— я́кості
якіс/	— я́кісний

!язик	— язи́к
язиц'/	— на язицí
язич/	— язичóк

!ялоз/	— ялóзити
ялож/	— ялóжу

!ярм/	— ярмó
ярем/	— ярéмний
ярмл/	— уярмля́ти

!ясл/	— я́сла	
ясел	— я́сел
ясель/	— я́сельний

!ясн/	— я́сна
ясен	— я́сен

!ясн/	— ясни́й
ясен	— я́сен (день)	

!ячмінь	— ячмíнь
ячмін/	— ячмíнний
ячмен'/	— ячмéню

!ящик	— я́щик
ящич/	— я́щичок

!/барв/	—	за/бáрв/и/ти
!барвл/	—	за/бáрвл/ен/ий
!безпéк/	—	безпéк/а
!/безпеч/	—	за/безпéч/ен/ий
!будень/	—	бýдень
!будн/	—	бýдн/я
!буден/	—	будéн/н/ий
!білк/	—	бíлк/а
!білц/	—	бíлц/і
!білоч/	—	бíлоч/к/а
!білок	—	білок
!божевіль/	—	божевíль/н/ий
!божевол/	—	божевол/і/ти
!божевілл/	—	божевíлл/я 
!бруньк	—	брýньк/а
!бруньц/	—	брýньц/і
!бруньок	—	бруньóк
!будень	—	бýдень
!будн/	—	бýдн/я
!буден/	—	будéн/н/ий
!бузувір	—	бузувíр
!буйвол/	—	бýйвол/ов/ий
!ввіч/	—	ввíч/лив/ий
!вда/	—	вда/вá/ти
!уда/	—	уда/вá/ти
!вдач/	—	вдáч/а
!ведмед/	—	ведмéд/ик
!ведмідь	—	ведмíдь
!ведмеж/	—	ведмеж/á 
!велич/	—	велич/áв/ий, велич/áль/н/ий 
!веселк/	—	весéлк/а
!веселц/	—	весéлц/і
!веселоч/	—	весéлоч/к/а
!веселок	—	весéлок
!вибач/	—	вибáч/лив/ий
!вигод/	—	вигóд/а
!вигід/	—	вигíд/н/ий
!вида/	—	вида/в/ни́ц/тв/о, вида/в/éць
!виклад/	—	виклад/áч, виклад/áти
!виключ/	—	ви́ключ/ен/ий
!викон/	—	викон/áв/ськ/ий
!вилиц/	—	вилиц/ювáт/ий
!вим’/	—	ви́м’/я, ви́м’/ячк/о
!виноград/	—	виногрáд/ар
!виняток	—	ви́няток
!винятк/	—	винятк/óв/ий
!випад/	—	випад/кóв/ий
!випас/	—	ви́пас/ти
!випа/	—	ви́па/в 
!вираз/	—	вирáз/н/ий
!вираж/	—	вираж/áльн/ий 
!вируч/	—	вируч/á/ти
!виснов/	—	ви́снов/ок
!виснув/	—	ви́снув/а/ти 
!вихов/	—	вихов/н/и́й
!відваг/	—	відвáг/а
!відваз/	—	відвáз/і
!відваж/	—	відвáж/н/ий
!відлиг/	—	відли́г/а
!відлиз/	—	відли́з/і
!відмін/	—	відмíн/ник
!віднос/	—	віднóс/н/ий
!віднош/	—	віднóш/енн/я
!відповід/	—	відповíд/н/ий, відповід/á/льн/ий 
!відрад/	—	відрáд/а
!відстань	—	вíдстань
!відстанн/	—	вíдстанн/ю	
!відчайдух/	—	відчайдýх
!відчайдуш/	—	відчайдýш/н/ий
!вплив/	—	вплив/á/ти (на кого)
!вплив	—	вплив
!вправ/	—	впрáв/н/ість
!вправл/	—	вправл/я́/ти/ся 
!врод/	—	врод/а
!врочист/	—	врочи́ст/ий
!урочист/	—	урочи́ст/ий
!в’язн/	—	в’язн/и́ц/я
!в’язень	—	в’я́зень
!горілк/	—	горíлк/а
!горілц/	—	горíлц/і
!горілч/	—	горілч/áн/ий
!горілоч/	—	горíлоч/к/а
!горлиц/	—	гóрлиц/я
!горлич/	—	гóрлич/к/а
!губк/	—	гýбк/а
!губц/	—	гýбц/і
!губок/	—	гýбок
!губч/	—	гýбч/аст/ий (рослина)
!дібров/	—	дібров/а
!/довóл/	—	за/довóл/ен/ий
!/довíль/	—	за/довíль/н/ий
!доклад/	—	доклáд/н/ий 
!докуч/	—	докуч/á/ти
!долон/	—	долóн/я
!донос	—	донос
!донес/	—	донéс/енн/я (повідомлення)
!досад/	—	досáд/а
!досадж/	—	досадж/ý
!доскон/	—	доскон/áл/ий
!забу/	—	забу/вá/ти
!забудь/	—	забýдь/к/о
!завод	—	завóд (підприємство)
!загін	—	загíн
!загон/	—	загóн/ом (група, ділянка землі)
!заздр/	—	зáздр/ість
!заклад	—	зáклад (установа)
!закон	—	закон
!/законн/	—	без/закóнн/я
!залізниц/	—	залізни́ц/я
!залізнич/	—	залізни́ч/н/ий
!залиц/	—	залиц/я́ль/ник
!залік/	—	залік/óв/ий
!замок	—	зáмок
!замк/	—	зáмк/у
!замоч/	—	зáмоч/ок (будівля)
!заповід/	—	заповід/á/ти
!заповідь	—	зáповідь
!заповідд/	—	зáповідд/ю
!зараз/	—	зарáз/а
!зараж/	—	зараж/á/ти
!засад/	—	засáд/а (принцип)
!захист	—	зáхист
!захищ/	—	захищ/á/ти
!захід	—	зáхід
!заход/	—	зáходу (частина світу)
!зброй/	—	збрóй/н/ий
!звитяг/	—	звитя́г/а
!звитяз/	—	звитя́з/і
!звитяж/	—	звитя́ж/н/ий
!зворуш/	—	зворýш/лив/ий (схвильований)
!злигодн/	—	зли́годн/і
!злидн/	—	зли́дн/і
!злидень	—	зли́день
!злид/	—	зли́д/ар (помилкова деетимологізація -ень на -ар)
!зразок	—	зразóк
!зразк/	—	зразк/á
!зразоч/	—	зразóч/ок
!коломийк/	—	коломи́йк/а
!коломийц/	—	коломи́йц/і
!копійк/	—	копíйк/а
!копійц/	—	копíйц/і
!копійок	—	копíйок
!копієч/	—	копíєч/к/а
!копійч/	—	копійч/ин/а
!мотовил/	—	мотови́л/о
!намет	—	намéт
!напасть	—	нáпасть
!напас/	—	напáс/ник
!нарис/	—	нарис/óв/ець
!наруг/	—	нарýг/а
!наруз/	—	наруз/і
!неборак	—	неборак
!неборач/	—	неборáч/е
!невіглас	—	невíглас
!негод/	—	негод/а
!недолік	—	недолік
!недуг/	—	недуг/а
!недуз/	—	недýз/і
!недуж/	—	недýж/ий
!неміч/	—	нéміч/н/ий
!немоч/	—	немоч/і
!ненавид/	—	ненави́діти
!ненависть	—	ненáвисть
!ненавис/	—	ненави́с/н/ий
!нісеніт/	—	нісенíт/н/иц/я, нісенíт/н/ий
!нічліг	—	нічлíг
!нічліж/	—	нічлíж/н/ий
!/обов’яз/	—	з/обов’яз/ан/ий
!обруч/	—	обруч/éв/ий
!обряд/	—	обряд/óв/ий
!опеньок	—	опéньок
!опеньк/	—	опéньк/а
!перемог/	—	перемóг/а
!перемоз/	—	перемóз/í
!перемож/	—	перемóж/н/ий
!пересічн/	—	перéсічн/ий (посередній)
!південь	—	пíвдень
!півдн/	—	пíвдн/я (частина світу)
!північ	—	пíвніч
!півноч/	—	пíвноч/і (частина світу)
!підвал	—	підвáл
!підваль/	—	підвáль/н/ий
!підлог/	—	підлóг/а
!підлоз/	—	підлóз/і
!підмет/	—	підмет/о́в/ий (грам.)
!підмет/	—	підмéт/к/а
!підошв/	—	підóшв/а
!підпіль/	—	підпíль/н/ий
!підпілл/	—	підпíлл/я	
!повідь/	—	рóз/повідь
!повіс/	—	повíс/ти
!повід/	—	повід/á/ти
!повість	—	пóвість
!повіст/	—	повіст/éв/ий
!погод/	—	погóд/а
!погож/	—	погóж/ий
!подат/	—	подáт/ок
!подать	—	пóдать
!податт/	—	пóдатт/ю
!подвиг/	—	пóдвиг
!подвиж/	—	подви́ж/ник
!подушк/	—	подýшк/а
!подушц/	—	подýшц/і
!подушок/	—	подушóк
!помог/	—	помог/ти́
!поміг/	—	помíг
!помаг/	—	помаг/á/ти
!поміч	—	пóміч        
!поруш/	—	порýш/ник
!пригод/	—	пригóд/а
!присяг/	—	прися́г/а
!присяз/	—	прися́з/і
!присяж/	—	прися́ж/н/ий	
!пристой/	—	пристóй/н/ий
!/притом/	—	не/притóм/н/ий
!причас/	—	причáс/ник
!причаст/	—	причáст/я
!причащ/	—	причащ/á/ти
!причин/	—	причин/я́/ти (бути причиною)
!причіл/	—	причíл/ок
!причіль/	—	причíль/н/ий
!прия/	—	при́я/тель, при́я/знь
!прод/	—	прод/а/вá/ти
!пропас/	—	пропáс/ти
!пропасть	—	прóпасть
!речовин/	—	речови́н/н/ий
!розпук/	—	розпýк/а
!розпуц/	—	розпýц/і
!розчин	—	розчин (речовина)
!ручк/	—	рýчк/а
!ручц/	—	рýчц/і (предмет)
!свідок	—	свíдок
!свідоц/	—	свідó/цтв/о
!свідч/	—	свíдч/и/ти
!свідом/	—	свідóм/ий
!спідниц/	—	спідни́ц/я
!спіднич/	—	спідни́ч/к/а
!установ/	—	устанóв/а
!учас/	—	учáс/ник
!участь	—	ýчасть
!аван/	—	аванпóстний
!авіа/	—	авіамоделювáння
!авто/	—	автовантáжник
!агро/	—	агроділя́нка
!бавовн/	—	бавовнопряди́льний
!багат/	—	багатомóвний
!/баз/	—	автобáза
!/барв/	—	багатобáрвний
!біл/	—	біловолóсий
!біо/	—	біофíзик
!благ/	—	благонадíйний
!/бор/	—	багатобóрство
!/буд/	—	автобудівни́й, автобудівни́к, автобудувáння
!важ/	—	важкодýм
!/вар	—	кашовáр
!/вар/	—	смоловарíння
!вело/	—	велокрóс
!верх/	—	верхолáз
!взаєм/	—	взаємови́ручка
!/вид/	—	милови́дний
!вис/	—	високогíрний
!внутрі/	—	внутріклáсовий, внутрішньогосподáрський
!/владд/	—	двовлáддя
!вогн/	—	вогнестрíльний
!вод/	—	водовóз
!/воз	—	тепловóз
!все/	—	всезнáйство
!газ/	—	газопрóвід
!/генез	—	психогенéз
!гео/	—	геосфéра
!гігр/	—	гігрометри́чний
!гіпс/	—	гіпсовипáлювальний
!гірнич/	—	гірничодобувни́й
!глин/	—	глинорíзка
!/гляд	—	верхогля́д
!/годин/	—	п’ятигоди́нний
!голов/	—	головолóмка
!/голос/	—	повноголóсний
!/грам/	—	телегрáма
!/гран/	—	багатогрáнний, шестигрáнник
!/граф	—	автóграф
!/граф/	—	фотографíчний, лексикогрáфія
!/груд/	—	вузькогрýдий
!ґрунт/	—	ґрунтозахисни́й
!далек/	—	далекосхíдний
!дерев/	—	деревообрóбний
!добр/	—	добрози́чливий
!довг/	—	довгострокóвий
!дом/	—	домогосподáрка
!/дроб/	—	зернодробáрка
!дров/	—	дроворýб
!електр/	—	електромонтéр
!єдин/	—	єдиноначáльний
!жир/	—	жирообрóбний
!житт/	—	життєздáтний
!жов/	—	жовтогаря́чий
!/завод	—	електрозавóд
!загальн/	—	загальнодостýпний
!/бир/	—	зернозбирáльний, сінозбирáння
!звір/	—	звіролóв
!звук/	—	звукооперáтор
!/звуч/	—	милозвýчний
!/здат/	—	життєздáтний, життєздáтність
!зерн/	—	зерносуши́льний
!зл/	—	зловорóжий
!/зна/	—	мовознáвець, металознáвство, металознáвство, мовознáвчий
!/знач/	—	багатознáчний
!золот/	—	золотошукáч
!зоо/	—	зооветеринáрний
!/їд	—	м’ясої́д 
!/їд/	—	м’ясої́дний
!карт/	—	картографувáти
!/кисл/	—	сірчаноки́слий
!кіно/	—	кіносеáнс
!/клас/	—	п’ятиклáсний, п’ятиклáсник
!книг/	—	книгознáвець
!/коп	—	землекóп
!/крат/	—	багатокрáтний
!/кут/	—	шестикýтник
!легк/	—	легковíрний
!лж/	—	лжесвíдок
!/ли/	—	мідноливáрний
!/лист/	—	дволи́стий
!лів/	—	лівоберéжний
!ліс/	—	лісосмýга
!літ/	—	літопи́сний
!/літ/	—	багатолíтній
!/літт/	—	сорокалíття
!/лог	—	філóлог
!/логіч/	—	психологíчний
!/лог/	—	психолóгія
!/люб	—	працелю́б
!/люб/	—	свободолю́бець
!люб/	—	вільнолю́бність
!/люб/	—	миролю́бно, користолю́бство
!/люд/	—	велелю́дний
!магніт/	—	магнітофóн
!макр/	—	макрофотогрáфія
!мал/	—	малознáчний
!/ман	—	меломáн
!марн/	—	марнослíв’я
!/машин/	—	електромаши́на
!мега/	—	мегафóн
!/майстер	—	електромáйстер
!/мет	—	вогнемéт
!метал/	—	металолóм
!/метр	—	термóметр
!/метр/	—	радіометри́чний, шестиметрóвий
!метр/	—	калоримéтрія
!мікр/	—	мікролітрáжний
!/мір	—	землемíр
!/місяч/	—	шестимíсячний
!мног/	—	многокýтник
!/мов/	—	багатомóвний
!/мотор/	—	легкомотóрний
!навкол/	—	навколосерцéвий
!/навт	—	космонáвт
!напів/	—	напівфабри́чний
!нафт/	—	нафтоперерóбний
!/ніж/	—	коротконíжка
!/ніс	—	кривонíс
!/ног/	—	коротконóгий
!/нос	—	дровонóс
!/нос/	—	зброєнóсець
!/нос/	—	броненóсний
!одн/	—	однокварти́рний
!/ок/	—	одноóкий
!!/о/	—	нафтоочисни́й, спиртоочи́щувальний
!палео/	—	палеолíт
!пан/	—	панслов’я́нський
!/партій	—	багатопартíйний
!перш/	—	першоря́дний
!/пис	—	правóпис
!/пис/	—	правопи́сний
!після/	—	післямóва
!/план	—	аероплáн
!плод/	—	плодонóсний
!повітр/	—	повітророзподíльний
!/подіб/	—	хвилеподíбний, променеподíбно
!полі/	—	полівалéнтний
!правд/	—	правдомóвний
!прав/	—	правосторóнній
!/прац/	—	профпрацівни́к
!/про/	—	водопрóвід, теплопровíдни́й, водопрони́кний
!/прокат/	—	сталепрокáтний, сталепрокáтник
!/промисл/	—	електропромислóвість
!проти/	—	протидíя
!псевдо/	—	псевдомистéцтво
!псих/	—	психотерапíя
!радіо/	—	радіомóвлення
!/раз/	—	одноразóвий
!риб/	—	рибообрóбний
!рівн/	—	рівноскладóвий
!/різ	—	дернорíз
!різн/	—	різночитáння
!/річ/	—	дворíчний
!/роб	—	землерóб
!рук/	—	рукóпис
!руч/	—	ручни́й
!/ряд/	—	першоря́дний
!сам/	—	самоупрáва
!світл/	—	світломíр
!свіж/	—	свіжопогóлений
!серед/	—	середземномóрський
!середнь/	—	середньости́глий
!сив/	—	сивоборóдий
!/склад/	—	багатоскладóвий
!скл/	—	скловáрний
!/скоп	—	мікроскóп
!/скоп/	—	гігроскопíчний, мікроскопíя
!слаб/	—	слабодíючий
!слов/	—	словотвíрний
!спів/	—	співрозмóвник
!стар/	—	старосвíтський
!стерео/	—	стереомагнітофóн
!/стій/	—	вологостійки́й, вологостíйкість
!/сторон/	—	багатосторóнній
!/сфер/	—	стратосфéра
!!/с/	—	книгосхóвище
!судн/	—	судноплáвний
!/твір	—	словотвíр
!/твор/	—	новоутвóрення, рукотвóрний
!теле/	—	телепередáча
!тепл/	—	теплови́трата
!/терап/	—	фізіотерапíя
!термо/	—	термóметр
!/технік	—	гідротéхнік
!/технік/	—	агротéхніка
!/техніч/	—	агротехнíчний
!/тисяч/	—	багатоти́сячний
!товст/	—	товстосýм
!тонк/	—	тонкопряди́льний
!торф/	—	торфорозрóбка
!транс/	—	трансатланти́чний
!/трив/	—	вогнетривки́й
!турб/	—	турбоелектри́чний
!/у/	—	самоуправлíння, шлакоутвóрення
!/фаз/	—	багатофáзний
!/фізич/	—	електрофізи́чний
!фізіо/	—	фізіотерапевти́чний
!фон/	—	фоногрáфія
!форм/	—	формотвóрення
!фото/	—	фотогрáфія
!/хід	—	всюдихíд
!/хім/	—	теплохімíчний
!холод/	—	холодостійки́й
!цикл/	—	циклометри́чний
!/час/	—	рівночáсний
!червон/	—	червоношкíрий
!через/	—	черезплíчник
!чорн/	—	чорнóслив
!швидк/	—	швидкохíд
!широк/	—	широколи́ций
!шовк/	—	шовкопряди́льний
!щонай/	—	щонайшви́дше
!якнай/	—	якнайлíпший